****************************************
*   * * * ** *       * **    *   ****  *
*   *   * ** * ***** * *  ** * *       *
*   * * * ** * ***** * ***** * * *******
** **        * ***** *       * *       *
*     ** *** *       * * ***** * *** ***
* * * ** *** **** **** *       * *     *
* * *           * *    * *******       *
* * * * * ***** * * ** *         *     *
* * *****       * * ** * ******* *** ***
* *       *****     ** * ***     *   * *
* ** **** ***** * * *        * *   * * *
*               * * * *** ** * *** * * *
**** ***  **** ** * * *** **       * * *
*      *                  ** ** ** * * *
*      * ******** ** ** * ** **      * *
*      *        * *  ** * ** ** **** * *
*      * ** ***** * **                 *
*** **** **            **** **** ***** *
*           ***   ****                 *
****************************************