*********************************************************************************************************
*   *                       *                   *                                               *       *
*   *   *****************   *   *********   *   *********   *********************************   *   *   *
*   *       *   *           *   *           *               *       *                   *   *   *   *   *
*   *****   *   *   *************   *************************   *****   *********   *   *   *   *   *   *
*           *   *               *   *           *       *               *           *       *   *   *   *
*************   *************   *   *   *****   *   *   *****   *********   *************   *   *****   *
*               *               *           *       *       *       *       *       *       *       *   *
*   *************   *************************************   *********   *****   *****   *********   *   *
*                   *       *               *               *           *       *       *           *   *
*   *****************   *   *   *   *****   *   *************   *********   *****   *****   *********   *
*               *       *   *   *   *       *   *       *       *           *           *   *       *   *
*************   *****   *   *   *   *   *****   *   *****   *   *********   *   *********   *   *   *   *
*   *       *           *   *   *   *           *   *       *   *       *       *   *       *   *       *
*   *   *   *************   *****   *************   *   *****   *   *   *   *****   *   *****   *****   *
*       *               *       *   *                   *   *       *   *           *   *       *   *   *
*   *************   *********   *   *   *****************   *********   *********   *   *   *****   *   *
*   *           *   *       *   *   *                   *       *       *       *   *   *       *   *   *
*   *   *****   *   *   *   *   *   *****************   *****   *   *****   *   *****   *****   *   *   *
*       *       *       *           *                           *           *                   *       *
*********************************************************************************************************